################
#......o..#..D.#
#...g.....#....#
#.g....S.B#....#
#...........o..#
###..g..g.#....#
#....#S...#.o..#
#@...#....#....#
################