###############
#....s...#.M..#
#........#q...#
#.s......#....#
#Q.....k..C...#
##.......#....#
#...#s...#....#
#@..#..q.#B...#
###############