################
#......g....d..#
#..#d..........#
#.g#F....d..d..#
#..#...d...F...#
#..#F...o.#....#
#..#......#....#
#@.#......#..A.#
################